
Frame 1a — field + ▐↓▌ History button
+----------------------------------------+
|                                        |
|  /etc/hosts          ▐↓▌               |
|                                        |
|                                        |
|                                        |
|                                        |
|                                        |
|                                        |
|                                        |
|                                        |
|                                        |
|                                        |
+----------------------------------------+

Frame 1b — history dropped (oldest at top, current value recorded)
+----------------------------------------+
|┌────────────────────┐                  |
|│ /usr/bin          ▲│▐↓▌               |
|│ ~/dev             ▒│                  |
|│ /etc/hosts        ▒│                  |
|│                   █│                  |
|│                   ▒│                  |
|│                   ▼│                  |
|└────────────────────┘                  |
|                                        |
|                                        |
|                                        |
|                                        |
+----------------------------------------+

Frame 1c — picked → field filled
+----------------------------------------+
|┌────────────────────┐                  |
|│ ~/dev              │▐↓▌               |
|│ ~/dev             ▒│                  |
|│ /etc/hosts        ▒│                  |
|│                   █│                  |
|│                   ▒│                  |
|│                   ▼│                  |
|└────────────────────┘                  |
|                                        |
|                                        |
|                                        |
|                                        |
+----------------------------------------+
  History picked: ~/dev

Frame 2a — editable ComboBox (empty)
+----------------------------------------+
|                                        |
|                    ▐↓▌                 |
|                                        |
|                                        |
|                                        |
|                                        |
|                                        |
|                                        |
|                                        |
|                                        |
|                                        |
|                                        |
+----------------------------------------+
  editable filtered to: Rust

Frame 2b — typed "ru" → field narrows the candidates
+----------------------------------------+
|                                        |
|  ru                ▐↓▌                 |
|                                        |
|                                        |
|                                        |
|                                        |
|                                        |
|                                        |
|                                        |
|                                        |
|                                        |
|                                        |
+----------------------------------------+

Frame 2c — dropdown shows the single match
+----------------------------------------+
|┌──────────────────────┐                |
|│ Rust                ▲│                |
|│                     ▓│                |
|│                     ▓│                |
|│                     ▓│                |
|│                     ▓│                |
|│                     ▼│                |
|└──────────────────────┘                |
|                                        |
|                                        |
|                                        |
|                                        |
+----------------------------------------+

Frame 2d — picked → text + value set
+----------------------------------------+
|┌──────────────────────┐                |
|│ Rust              ▐↓▌│                |
|│                     ▓│                |
|│                     ▓│                |
|│                     ▓│                |
|│                     ▓│                |
|│                     ▼│                |
|└──────────────────────┘                |
|                                        |
|                                        |
|                                        |
|                                        |
+----------------------------------------+
  editable value: Rust (text="Rust")

Frame 3a — select-only ComboBox showing "Blue" (read-only)
+----------------------------------------+
|                                        |
|  Blue              ▐↓▌                 |
|                                        |
|                                        |
|                                        |
|                                        |
|                                        |
|                                        |
|                                        |
|                                        |
|                                        |
|                                        |
+----------------------------------------+

Frame 3b — opened + typed "m" jumps to Magenta (type-ahead)
+----------------------------------------+
|┌──────────────────────┐                |
|│ Red                 ▲│                |
|│ Green               ▒│                |
|│ Blue                ▒│                |
|│ Cyan                █│                |
|│ Magenta             ▒│                |
|│ Yellow              ▼│                |
|└──────────────────────┘                |
|                                        |
|                                        |
|                                        |
|                                        |
+----------------------------------------+

Frame 3c — picked
+----------------------------------------+
|┌──────────────────────┐                |
|│ Magenta           ▐↓▌│                |
|│ Green               ▒│                |
|│ Blue                ▒│                |
|│ Cyan                █│                |
|│ Magenta             ▒│                |
|│ Yellow              ▼│                |
|└──────────────────────┘                |
|                                        |
|                                        |
|                                        |
|                                        |
+----------------------------------------+
  type-ahead landed on: Magenta
  select-only value: Magenta

Frame 4a — dropdown open over "keep-me"
+----------------------------------------+
|┌────────────────────┐                  |
|│ alpha             ▲│▐↓▌               |
|│ beta              ▒│                  |
|│ keep-me           ▒│                  |
|│                   █│                  |
|│                   ▒│                  |
|│                   ▼│                  |
|└────────────────────┘                  |
|                                        |
|                                        |
|                                        |
|                                        |
+----------------------------------------+

Frame 4b — Esc cancelled; field unchanged
+----------------------------------------+
|┌────────────────────┐                  |
|│ keep-me            │▐↓▌               |
|│ beta              ▒│                  |
|│ keep-me           ▒│                  |
|│                   █│                  |
|│                   ▒│                  |
|│                   ▼│                  |
|└────────────────────┘                  |
|                                        |
|                                        |
|                                        |
|                                        |
+----------------------------------------+
  after Esc, popup open? false
  after Esc, field unchanged: keep-me

Done — a History MRU dropdown, an editable + a select-only ComboBox, and an Esc-cancel.
